R 540 540 
NO ./textures/bluestone.xpm
SO ./textures/bluestone.xpm
WE ./textures/bluestone.xpm
EA ./textures/bluestone.xpm
S ./textures/sprite_1.xpm
F 20,50,70
C 20,20,220



        11111111111111111111111111 
        10000000001100001000000001 
        1011000001110011102001111 
        10010000000000001000010001 
1111111111011000001110111111111111  
11110111111111011100000010001  
11110111111111011101010010001 
110000000110101011100000010001 
100020000001000001100000010001 
1000N000001 1000001101010010001 
1100000111010101111101111000111 
111101111111010111011110100001
111111111111111111111111111011
                           1
