R  1300 1300
NO ./textures/wall_3.xpm
SO ./textures/wall_2.xpm
WE ./textures/purplestone.xpm
EA ./textures/eagle.xpm
S ./textures/sprite_1.xpm
F 20,50,70
C 20,20,220
11111111111111111111111111111
10000000001100000000000011111
10110000011100000020000011111
10010000000000000000000011111
11111111101100000111000011111
10000000001100000111011111111
11110111111111011100000010001
11110111111111011101010010001
11000000110101011100000010001
10002000000000001100000010001
10000N0000000001101010010001
1100000111010101111101000001
11110111111101011101111010001
11111111111111111111111111111
