R 540 540
NO ./textures/lol.xpm
SO ./xpm/walls/stone2.xpm
WE ./textures/wall_3.xpm
EA ./xpm/walls/stone4.xpm
S ./textures/sprite_1.xpm
F 20,50,70
C 20,20,220

                   111
                   101
                111101111
                100000001
               11000100011
              1110010100111
              1000001000001                                    
     111111111100000W00000111111111111111111111111111111111111111111111111111
     1000000000000001000000000000000000000000000000000000000000000000000000011
     1011111111111001010011111111111111111111111011111111111110111111111111011
     101000000011000100011000000000000000000001010000000000001010000000000101
     101000000001000000010000000000000000000000101000000000001010000000000101
     101000000001111011111111111111111111111111101110000000001010000000000101
     101000000000001000000000000000000000000000000010000001111011100000000101
     101111111111111111111111001111111110110111111010000001000000100000000101
     100000000000000000000000001100000010000100111011111111011110111111111101
     11111111111111111110111111111111111111111110000000000001  10000000000001
                       10000000000000000000000000111111111111  11111111111111
                       111111111111111111111111111
                                             