R 1200 850
NO ./textures/wall_3.xpm
SO ./textures/wall_2.xpm
WE ./textures/purplestone.xpm
EA ./textures/eagle.xpm
S ./textures/sprite_1.xpm
F 20,50,70
C 20,20,220
       1111111111111111111111111
       1000000000110000000000001
       1011000001110000002000001
       1001000000000000000000001
111111111011000001110000000000001
100000000011000001110111111111111    
11110111111111011100000010001
11110111111111011101010010001
11000000110101011100000010001
10002000000000001100000010001
10000000000000001101010010001
11000001110101011111010000N0111
11110111 1110101 101111010001
11111111 1111111 111111111111
