R  1300 1300
NO ./textures/wall_3.xpm
SO ./textures/wall_2.xpm
WE ./textures/purplestone.xpm
EA ./textures/eagle.xpm
S ./textures/sprite_1.xpm
F 20,50,70
C 20,20,220
      1111111111111111111111111  
      1000000000110000000000001  
      1011000001110000002000001  
      1001000000000000000000001  
111111111011000001110000111111
10000000001100000111011111111  
1111011111111101110000001  
1111011111111101110101001  
1100000011010101110N00001  
1000200000000000110000001
100000000000000110101001  
11000001110101011111010011
  11110111111101011101111010001  
11111111 1111111111 11111111
  